###########
#A#       #
# # ### ###
#     # # #
# # ### # #
# #   #   #
# # # # ###
# # # # # #
# ### # # #
# #   #  B#
###########