############################################################################################
A   # #                         #   # #   #     #       # # #                             ##
# ### # ####################### # ### # ### ##### ####### # # ##### ######### ### # ### # ##
#                             # #             # # # # #   #   # # # #       #   # #   # # ##
# # ##### # ################# ### ######### ### # # # # ### ### # ### ### ### ####### # ####
# #     # #                 # #       #   #                   #         #   #       # #   ##
# # ##### ### # ############### ####### ############# ######### ######### ########### # # ##
# #     #   # #                     #               #     #       #     #           # # # ##
# # # # ### ##### # ################# ####### # ########### ####### ##### ##### ### ########
# # # #   #   # # #                 #       # #       # # #             #   # # # #   #   ##
### # ######### ##################### ################# # # ### ##### ####### ### ##### ####
#   #         # # #                             #             #     #           #   # # # ##
### # # ##### # # # ############# # ##### # # ### ### ############# # ########### ### # # ##
#   # #     #                   # #     # # #       #         #   # #                     ##
### ### ##### # ### # ##### ########### # ######### ####### ### ####### # # # ##### ########
#     #     # #   # #     #           # #         #       #           # # # #     #     # ##
### ### ### # # # ### # # ######### # ##### ##### ### # ######### ##### ### # ########### ##
#     #   # # # #   # # #         # #     #     #   # #         #   #     # #             ##
# # ### # ##### # ##### # # ####### ### # # # # ########### ### # ##### # ### # ######### ##
# #   # #     # #   #   # #       #   # # # # #           #   # #     # # #   #         # ##
### # # # ### # # # ##### ################### # # # ### ####### # ##### # ### ######### ####
#   # # #   # # # #     #           #       # # # #   #       # #     # # #           #   ##
# # # # # # ### # # # ########### ### ####### # ######### # # # # # ### ##### # ##### ### ##
# # # # # #   # # # #           #           # #         # # # # # #   #   #   #     #   # ##
# # ##### # # # ### # ####### # # ### ### ##### # ##### # ####### # ### ##### # ##### # ####
# #     # # # #   # #       # # #   #   #   # # #     # #       # #   #   #   # #   # #   ##
# # ####### ### ### # # # # # ####### ####### ### ####### # ######### # ##### # # ##########
# #       #   #   # # # # # #       #           #       # #         # #     # #           ##
# # # # ##### # ##### # # ### ### ### # # ### # # ##### # ##### ########### # # ### ##### ##
# # # #     # # #   # # #   #   #   # # #   # # #     # #     #           # # #   #     # ##
# # # # ### # # # ##### # ####### # # # # # # ### # # # # ####### # ### # # ### # ##### # ##
# # # #   # # #       # #       # # # # # # #   # # # # #       # #   # # # #   #     # # ##
### # # # # ####### # ### # ######### ##### ##### # # # # ### ### ##### # # # # ##### # ####
#   # # # #       # #   # #         #     #     # # # # #   #   #     # # # # #     # #   ##
# # # # # # # ### ##### # # ############# # # ##### # ### # # # # ### ##### ### # # # # # ##
# # # # # # #   #     # # #             # # #   #   #   # # # # #   #     # # # # # # # # ##
# # ### # # ### # ### ### # ### # ### ####### ##### # ##### # # ##### ### # # # # ### ### ##
# #   # # #   # #   #   # #   # #   #       #     # #     # # #     #   # # #   #   #   # ##
### # ### # # ### ####### # # # ####### ########### # # ##### # ### ######### # # # # # ####
#   # #   # #   #       # # # #       #     #     # # #     # #   #         # # # # # #   ##
### # ### # # ######### # # ### ### # ### ### ### # # # ##### ######### # ### ### # # ### ##
#   # #   # #         # # #   #   # #   #       # # # #     #         # #   #   # # #   # ##
# # # # # # # # # # # ### # # ####################### ### ### # ######### ### # # ### # # ##
# # # # # # # # # # #   # # #                       #   #   # #         #   # # #   # # # ##
# # ### # # ### ### # ### ### ### # # # # ### ##### # ### ### # # # ### # # ### # # # # ####
# #   # # #   #   # #   # #     # # # # #   #     # #   #   # # # #   # # #   # # # # #   ##
# # # # # ### # # # ######### # ### # # # ############# ### ### # # ### # # # # # # ### ####
# # # # #   # # # #       #   #   # # # #             #   #   # # #   # # # # # # #   #   ##
# # # ### # ### ########### # # # # # # # ######### ### # ##### ### # ### # # ##### ### # ##
# # #   # #   #         #   # # # # # # #         #   # #     #   # #   # # #     #   # # ##
# # # # ### ### ############# ####### # ### # # ####### ### # # ### # ##### # # ####### ####
# # # # #     #             #     #   #   # # #       #   # # #   # #     # # #       #   ##
### # # ### ### # ### # ####### ##### # # # # # # # # ##### ### # # ### ##### # ####### ####
#   # #   #   # #   # #       #     # # # # # # # # #     # #   # #   #     # #       # # ##
# # ### ### # # # ### # ##### ####### # # # ### # # ### # # ##### # # # # ### # # # ##### ##
# # #     # # # #   # #     #       # # # #   # # #   # # #     # # # # #   # # # #       ##
# # # # # # # # # ##### # # # ### ######### # ##### ### ####### # # # # ########### ### ####
# # # # # # # # #     # # # #   #         # #     #   #       # # # # #           #   #   ##
# # # ### # # ##### # # # # # ############# # # # # ##### # ####### ##### ##### ### # # # ##
# # # #   # #     # # # # # #             # # # # #     # #       #     #     # #   # # # ##
# # # ##### # # ### # ### # # ### # ### # # ### ### # ### ####### ##### # ##### ##### # # ##
# # # #     # #   # # #   # #   # #   # # #   #   # #   #       #     # #     #     # # # ##
# ### # # # # # # # ##### ### ##### ### # # ### ### # # ####### ### ####### # # ### ### ####
#   # # # # # # # #     #   #     #   # # #   # # # # #       #   #       # # #   #   #   ##
# # # # # # # ##### # # # # # # # # ### # ####### ##### ######### ### # ####### # # ### ####
# # # # # # #     # # # # # # # # #   # #             #         #   # #   #   # # #   #   ##
# ### # ### ####### ### ### # # ### ### # ### # # ########### # # # # # # # ######### # # ##
#   # # #         #   #   # # #   #   # #   # # #           # # # # # # #         # # # # ##
# # # ### # # # ### ### # # # # # # ### # ##### # ##### ### ####### # # # ### ##### ##### ##
# # #   # # # #   #   # # # # # # #   # #     # #     #   #       # # # #   # #         # ##
# ### # # ### # # # # # ### # ####### # # # ### # # ### # # # # # ####### ##### ### ### ####
# #   # # #   # # # # # #   #       # # # #   # # #   # # # # # #       #         #   #   ##
# # # # # # # # # # ### # # # # ### ### # # ##### # # # # ############# # # # ### ### # ####
# # # # # # # # # #   # # # # #   #   # # #   #   # # # #             # # # #   #   # # # ##
# ### # # # # # # # ######### # # # ##### ####### ### ################# # ##### ##### ### ##
#   # # # # # # # #         # # # #   #         #   #     #           # #     #     # # # ##
# # # # ### # # ### ########### # ### ### # # # # # ### # # ######### ### ############# # ##
# # # #   # # #   #           # #   # #   # # # # #   # #           #   #     # #   #     ##
# # # ##### # # # # # # ######### ### # # # ### # ### ### # # ######### # # # # # ### ### ##
# # #   #   # # # # # #         #   # # # #   # #   #   # # #         # # # #           # ##
# # # # # # # ### # # # # # # # # ### # # ### ### # ##################### # ####### # # ####
# # # # # # # #   # # # # # # # #   # # #   # #   #                 #   # #       # # #   ##
# # # # # # # # # ### # ######### ### ### ### ### ##### ########### # ######### # # ### # ##
# # # # # # # # #   # #       # #   # # #   # #       # #         #   #       # # #   # # ##
# ### # # # # # # ### # # # # # # ### # # ####### ### ### ############# ### # ####### ######
#   # # # # # # #   # # # # #   # # #   #   #       #                     # #       #     ##
# ### ### # # # # # # # # # ##### # ####### ##### ### # ######### ##### ####### # ##########
#   #   # # # # # # # # # #   #           #   #     # #         #     #       # #   #     ##
# # # ### ####### ##### ### ##### # # # ######### ####### ##### ######### ### ####### ######
# # #   #       #     # #       # # # #       #         #     #         #   #              B
############################################################################################
############################################################################################