#######################################################################################
#A                                            #                   # #   # #         # #
# # ### ### ##### # ### ### ### ### ### ####### ### # ### ######### # ### # ######### #
# #   #   #     # #   #   #   #   #   #           # #   #                           # #
# # ######### # ##### ########################### # ### ### # ##### ### ######### ### #
# #         # #     #           #               # #   #   # # #   #   #         #     #
# # # ### ### # ### # # ### ##### ##### # ##### ### ### ####### ############# # ### ###
# # #   #   # #   # # #   #           # #     #   #   #                     # #   # # #
# # # ### # # ##### # # ####### ####### ### ########### ##### ######### ####### ##### #
# # #   # # #     # # #       #     # #   #           #     #       # #       #     # #
# # # # # ##### # ##### # ######### # # # ################### ### ### ############### #
# # # # #     # #     # #         #   # #                   #   #                   # #
# ### # ####### # # # # # # ### # ################# ####### ######### ### ### ####### #
#   # #       # # # # # # #   # #                 #       #         #   #   #   # # # #
# # # # # ### # # ### # # # # ### # ##### # ######### ### ### # ################# # # #
# # # # #   # # #   # # # # #   # #     # #         #   #   # #       #             # #
# # # ### # ### # # # # ### # ### # ### # # ##### ######### ####### ### ############# #
# # #   # #   # # # # # #   #   # #   # # #     #         #       #     # # #       # #
# # # # # # # ### # # ##### # # ######### # # ##### # ################### # # ####### #
# # # # # # #   # # #   # # # #         # # #     # #       #         #             # #
# # # # # # ### # # # ### # ######### ### # # # ### ######### ######### ########### # #
# # # # # #   # # # #     #         #   # # # #   #       #                       #   #
# # ### ### # ### # # # ### # ##### ##### # # ############# ##### # # ####### # ### ###
# # #     # # # # # # #   # #     #     # # #                   # # #       # #   # # #
# ### # ### ### ### # ##### ### ##### ##################### ### # ##### # # ####### # #
#   # #   #       # #     #   #     #                     #   # #     # # #       #  B#
#######################################################################################