####################################################
#o            # # #       #   #             # #   ##
# # ########### # ### ##### ### ######### ### ### ##
# #         # #             #           #   # #   ##
# # # ### ### # ####### # ### ### ########### ### ##
# # #   #   # # # #   # #   #   #   #         # # ##
# # # ##### # # # # ######### ####### ######### # ##
# # #     # # # #       # #                 # # # ##
# ### ####### # # ### ### ### ############# # # # ##
# #                 #                     #      x##
####################################################
####################################################