############################################################################################
A                              # #   # # #           # #                             # # ##
# # ##### # ####### ##### ### ### # ### # # ####### # # ### ################### # ### # # ##
# #     # #       #     #   #               # # # # #                       # # #   # # # ##
# # # # # # ################# ### # ##### ### # # ########### ### # # ####### ######### # ##
# # # # # #                 #   # # #   # #                 #   # # #                   # ##
# # # ##### ##### ### ### ########### ##### ### ### # ##### # ### ##### ### ### # ####### ##
# # #     #     #   #   #     #   #           #   # #     # #   #     #   #   # #     #   ##
# # ### ##### # ####### ##### # ### ### ####### # # ### # # ########### # ### ### ##### ####
# #   #     # #       #     #         #   # # # # #   # # #           # #   #   #         ##
# # ### ######################### ######### # ####### # # # ################### ####### # ##
# #   # #                 # #   #                   # # # #         # #       #       # # ##
# # ### # ######### ####### # ##### # ####### # # ##### ############# # ##### ### ####### ##
# # #             #               # #       # # # #   # #                   #   #       # ##
# # # # # # ####### ######### # # # # # ####### ### ##### ############### ### ##############
# # # # # #       #         # # # # # #       # # #                 #   #   # #           ##
# # ### # # # ### # # ####### ##### ### # # ### # # ########### ##### ####### # ############
# # #   # # #   # # #       #     #   # # #   #               #         # # #             ##
# ##### # # # ####### ####### # # # # ############# ### # # ### # # # ### # ##### # ### ####
# #     # # #       #       # # # # #             #   # # #   # # # #           # #   #   ##
# ##### ####### ##### # # # # ### # # ######### ##### # ### ### # ### # ### ### ### ### ####
#   #         #     # # # # #   # # #         #     # #   #   # #   # #   #   #   #   #   ##
# ### # # # # ##### ### ### ##### # # ######### # # # ### # # ##### ### # # ### # ### ######
#   # # # # #     #   #   #     # # #       #   # # #   # # #     #   # # #   # #   #     ##
# # ### # # # ##### ### ########### # # # # ### # # ### # # # # ####### # # ####### # ######
# # #   # # #     #   #           # # # # #   # # #   # # # # #       # # #       # #     ##
# ### # # ### # ### ########### ### ####### ##### # # # # # # # ### ### # ####### # # ######
# #   # # #   #   #           #   #       #   #   # # # # # # #   #   # #       # # #     ##
# # # # # ### # ############### ### ### ### # ### # # # ### ### # # ##### # # # # ### ######
# # # # #   # #             # #   #   #   # # #   # # #   #   # # #     # # # # #   #     ##
# # # # ### # # # ### ### ### # ### # ### # # ### ### # ### ##### # ##### # ### # ### # # ##
# # # #   # # # #   #   #     #   # #   # # # # # # # #   #     # #     # #   # #   # # # ##
# # # # ### # # # # # # ### # # ##### ######### # # ########### ####### # # ### ######### ##
# # # #   # # # # # # #   # # #     #           #             #       # # #   # #       # ##
##### ### # ### # # # # # ####### ### ########### # ### ### # ### ### ##### ##### ##########
#       # #   # # # # # #       # # #           # #   #   # #   #   #     #             # ##
# # # # ### ### ### ### # # ### # # # # # # # # ### # # # ### # # ### # ### ### # ### ### ##
# # # # #     #   #   # # #   # # # # # # # # #   # # # #   # # #   # #   #   # #   #   # ##
### # ##### # ### # # # # # # ##### # # # ### # ### # ### # ##### ################# ##### ##
#   # #     #   # # # # # # #       # # #   # #   # # #   #     #           #     #       ##
# # # ### # # ### # ### # ### # # # # ### ##### ### ### # # ##### ##### ##### ##### # ### ##
# # # #   # #   # #   # #   # # # # #   #     # # #   # # #     #     # #         # #   # ##
# # # # ### # ### ##### # # # ### # # ### # ### # ### ### ##### # # ##### ########### # # ##
# # # # #   #   #     # # # #   # # #   # #   #     # #       # # #                 # # # ##
### # # # # # # # ##### # # # ##### ####### ### # ### ### # # ### # ##### # ##### # # ### ##
#   # # # # # # #     # # # #     #     #     # #   # #   # # #   #     # #     # # #   # ##
### ### ### ### # # ##### ### # ### ### ### # # ### ### # # ### # # # # ### # # # ####### ##
#     # #     # # #     #   # # # #   #   # # #   # #   # #   # # # # #   # # # #       # ##
# # # # ### # # # # # # # # # # # ####### ### ### ### # # # ### # # ####### # # ############
# # # #   # # # # # # # # # # #   #     #   #   # # # # # # # # # #       # # #           ##
### # # ### ### # # ##### ### # ### ### # ### ##### ##### ### ### ####### # # # # # ##### ##
#   # # #     # # #     #   # #       # # # #         # # #     #       # # # # # #     # ##
# # # # # # # # ### # # ####### # ######### # ######### # # ### ### # # # ### # ### # # ####
# # # # # # # #   # # #     # # #     #     # #         #     #   # # # #   # #   # # #   ##
### ####### # # ### ### # ### # # # ### ##### # ### # ### ### ##### ######### # ### # # # ##
#       #   # #   #   # #     # # #         #     # #   #   #     #         # #   # # # # ##
#   # # #             # #   #     # #   #   #   # # # # #   # #       # #     #   #       ##
# # # # # ### # # # # ### # ### # # ### ##### ### ### # # # ### # ### # # # ### ### ##### ##
# # # # #   # # # # #   # #   # # #   #     #   #   # # # #   # #   # # # #   #   #     # ##
# ### # # ### ### ####### # # # # # ### ### # ####### ### # ### ####### # # # ##### ### # ##
# #   # #   # # #     #   # # # # #   #   # #     #     # #   #       # # # #     #   # # ##
# # # ### # # # # ####### # # # # # # # ### # # # ### # # ######### ### ### ### ### ########
# # # #   # # #       #   # # # # # # #   # # # # #   # #         #   # #     #   #       ##
# # # ##### # ### ### ### # # ### # # ##### # # # ### ### # # # # ######### # # # # # ######
# # # #     #   #   # #   # #   # # #     # # # #   # #   # # # #         # # # # # #     ##
##### ##### # ### # # ### # # # ### # # # ### ### # # # # # # # ### ##### ##### ############
# #   #     #   # # #   # # # #   # # # #   #   # # # # # # # #   #     #     #           ##
# ####### # ### # ######### # ### # ### ######### # # # ##### # # ############# ##### ######
#         #   # #       #   #   # #   #         # # # #     # # #             #     #      B
############################################################################################
############################################################################################